21
21
XXXXXXXXXXXXXXXXXXXXX
X000000000X00000XS00X
XG000000X0X00000XXX0X
X0000000X0X0X00000X0X
XXXXXXXXX0X0X0X0X0X0X
X0000000X0X0X0000000X
X0000000X0X000000000X
X000000000X000X000X0X
X0XXXXXXXXXXX0X0XXX0X
X0000000X00000X000X0X
XXXXXXX0XXXXX000X0X0X
X00000000000X0000000X
X000000000XXX0X00XXXX
X000000000X000000000X
X000000000X0XXXXXXX0X
X000000000X0X0000000X
X0XXXXXXXXX000XXX000X
X000X000000000000000X
X000X0X0XX000000XXX0X
X00000X0000000000000X
XXXXXXXXXXXXXXXXXXXXX
