24
39
XXXXXXXXXXXXXXXXXXXXXXXXXXXXXXXXXXXXXXX
X000X00000000000000000000000000000X000X
X000X00000000000000000000000000000X000X
X0X0X0X0000000000000000000000000X0X0X0X
X00XXX000000000000000000000000000XXX00X
X000X00000000000000000000000000000X000X
XXXXXXXXXXXXXXXXXXXXXXXXXXXXXXXXXXXXXXX
X0EXS00000000000000X00000000000000SXE0X
X0XXXXXXXXXXXXXXXX0X0XXXXXXXXXXXXXXXX0X
X00000000000000XEX0X0XEX00000000000000X
XXXXXXXXXXXXXX00000X00000XXXXXXXXXXXXXX
X00000000000000XXXXXXXXX00000000000000X
X0XX0XXXXXXXXXXX000X000XXXXXXXXXXX0XX0X
X00X00000X0000000XEXEX0000000X00000X00X
XXEXXXXX0X0XXXX0XXXXXXX0XXXX0X0XXXXXEXX
XEXX000X0X0X0000000X0000000X0X0X000XXEX
X0000X00000X0X00E00X00E00X0X00000X0000X
XXXXXXXXXXXX0XXXXXXXXXXXXX0XXXXXXXXXXXX
X000000000000X00000X00000X000000000000X
X0E0X0X000000X00X00X00X00X000000X0X0E0X
XXXXX0XXXXXXXX00X0XXX0X00XXXXXXXX0XXXXX
X0E0X0X0000X0000X00G00X0000X0000X0X0E0X
X0000000XX000X0X0XXXXX0X0X000XX0000000X
XXXXXXXXXXXXXXXXXXXXXXXXXXXXXXXXXXXXXXX
