21
21
XXXXXXXXXXXXXXXXXXXXX
X0S0XX000XX000XXX000X
X000XXI0IXXE0EXXX0H0X
X000XX000XX000XXX000X
X000XX000XX000XXX000X
X0000000000000000000X
X000000E0000I0000000X
X0000000000000000000X
XXXXXXXXXXXXXXXX0000X
XXXXXXXXXXXXXXXX0000X
XXXXXXXXXXXXXXXX0000X
X0000000000000000000X
X0000000000000000000X
X0000000000000000000X
X000XX0I0XXXXXXX0H0XX
X000XX000XXXXXXX000XX
X000XXXXXXX0E0XXXXXXX
X000XXXXXXX000XXXXXXX
X0000000000000000000X
X000000000000000000GX
XXXXXXXXXXXXXXXXXXXXX