29
99
XXXXXXXXXXXXXXXXXXXXXXXXXXXXXXXXXXXXXXXXXXXXXXXXXXXXXXXXXXXXXXXXXXXXXXXXXXXXXXXXXXXXXXXXXXXXXXXXXXX
X0X0X0X0X0X0X0X0X0X0X00000000000000000000000000000000000000000000000000000000000000000000000000000X
XX0X0X0X0X0X0X0X0X0XX00XXX00X000X0XXX0XXXXX00XXX00X000X000X000X0XXX0XXXXX0X000X00XXX0000000X000000X
X0X0X0X0X0X0X0X0X0X0X0X000X0X000X00X0000X000X000X0X000X000X000X00X00X00000X000X0X000X00000XXX00000X
XX0X0X0X0X0X0X0X0X0XX0X00000X000X00X0000X000X00000X000X000X000X00X00X00000X000X0X00000000X0X0X0000X
X0X0X0X0X0X0X0X0X0X0X00XXX00X0X0X00X0000X000X00000XXXXX000X000X00X00XXXXX0X0X0X00XXX0000X00X00X000X
XX0X0X0X0X0X0X0X0X0XX00000X0X0X0X00X0000X000X00000X000X000X000X00X00X00000X0X0X00000X000000X000000X
X0X0X0X0X0X0X0X0X0X0X0X000X0X0X0X00X0000X000X000X0X000X0000X0X000X00X00000X0X0X0X000X000000X000000X
XX0X0X0X0X0X0X0X0X0XX00XXX000X0X00XXX000X0000XXX00X000X00000X000XXX0XXXXX00X0X000XXX0000000X000000X
X0X0X0X0X0X0X0X0X0X0X00000000000000000000000000000000000000000000000000000000000000000000000000000X
XXXXXXXXXXXXXXXXXXXXXXXXXXXXXXXXXXXXXXXXXXXXXXXXXXXXXXXXXXXXXXXXXXXXXXXXXXXXXXXXXXXXXXXXXXXXXXXXXXX
X0000000000000000000000000000000000000000000000000000000000000000000000000000000000000000000000000X
X0XXXX000XXX00X00000X0000000XXXXX0X000X0XXX00XXX0000XXXX000XXX00X00000X000000000000000000000000000X
X0X000X0X000X0X00000X000000000X000X000X00X00X000X000X000X0X000X0X00000X00000000000X00000XX000XX000X
X0X000X0X000X0X00000X000000000X000X000X00X00X0000000X000X0X000X0X00000X000000000000X00000X000X0000X
X0XXXX00X000X0X00000X000000000X000XXXXX00X000XXX0000XXXX00XXXXX0X00000X0000000XXXXXXX0000X0S0X0000X
X0X0X000X000X0X00000X000000000X000X000X00X000000X000X000X0X000X0X00000X000000000000X00000XXXXX0000X
X0X00X00X000X0X00000X000000000X000X000X00X00X000X000X000X0X000X0X00000X00000000000X00000000X000000X
X0X000X00XXX00XXXXX0XXXXX00000X000X000X0XXX00XXX0000XXXX00X000X0XXXXX0XXXXX0000000000000XXXXXXX000X
X0000000000000000000000000000000000000000000000000000000000000000000000000000000000000000000000000X
X0X000X0XXXXX0XXXX00XXXXX0X0000000000000000000000XXX00X000X00XXX00XXX0XXXX00000000000000XXXXXXX000X
X0X000X0X00000X000X0X00000X0000000X0000000000000X000X0X000X0X000X00X00X000X0000000X00000X00E00X000X
X0X000X0X00000X000X0X00000X00000000X0000X0X00000X000X0X000X0X000X00X00X000X00000000X0000X0E0E0X000X
X0XXXXX0XXXXX0XXXX00XXXXX0X000XXXXXXX0000G000000XXXXX0X000X0X000X00X00X000X000XXXXXXX000XE0H0EX000X
X0X000X0X00000X0X000X00000X00000000X0000X0X00000X000X0X000X0X000X00X00X000X00000000X0000X0F0F0X000X
X0X000X0X00000X00X00X0000000000000X0000000000000X000X00X0X00X000X00X00X000X0000000X00000X00E00X000X
X0X000X0XXXXX0X000X0XXXXX0X000000000000000000000X000X000X0000XXX00XXX0XXXX00000000000000XXXXXXX000X
X0000000000000000000000000000000000000000000000000000000000000000000000000000000000000000000000000X
XXXXXXXXXXXXXXXXXXXXXXXXXXXXXXXXXXXXXXXXXXXXXXXXXXXXXXXXXXXXXXXXXXXXXXXXXXXXXXXXXXXXXXXXXXXXXXXXXXX