23
23
XXXXXXXXXXXXXXXXXXXXXXX
XZZZZZZZZZZZZZZZZZX0S0X
XZX0000000000000000000X
XZX0000000000000000000X
XZX0000000000000000000X
XZ0000ZZZZZZZZZZZZZZZZX
XZ0000ZXXXXXXZ00000000X
XZ0000ZXXXXZ0000000000X
XZ0000ZXXZ00000ZZZ000ZX
XZ0000ZZ000000Z00Z000ZX
XZ0000ZX00000Z0G0Z000ZX
XZ0000ZX0000Z0000Z000ZX
XZ0000ZZ00000Z000Z000ZX
XZ0000ZZZ00000000Z000ZX
XZ0000ZZZZ0000000Z000ZX
XZ0000Z0F0XXXXXXXZ000ZX
XZ0000Z000XXXXXXXZ000ZX
XZ0000ZZZZZZZZZZZZ000ZX
XZ00000000000000000000X
XZ00000000000000000000X
XZ00000000000000000000X
XZZZZZZZZZZZZZZZZZZZZZX
XXXXXXXXXXXXXXXXXXXXXXX