39
53
XXXXXXXXXXXXXXXXXXXXXXXXXXXXXXXXXXXXXXXXXXXXXXXXXXXXX
XS00000000000X00000000000000000000000000000000000000X
XXXXXXXXXXXX0X0X0XXXXXXXXXXXXXXXXXXXXXXXXXXXXXXXXXX0X
X000000000000X0X0000000000000000000X0000000000000000X
X0XXXXXXXXXXXX0X00E0000000000000000X0000000000000000X
X000000000000X0X00000F00XXX00000XXXX0000XXX000000000X
X0XXXXXXXXXXXX0X000000X000XFXX00000X0XXXXEXXXXEXXXX0X
X000000000000X0XXXXXXXXXXH000XX0XX0X000000000XXX0000X
XX00X00X00X00X0X000000000000000E000X0000000000000000X
XXE0XE0XE0X00X0X00X0X0000000000X000X000000000X0X0000X
XXXXXXXXXXX00X0XXXX0XXXXXXXXXXXXXXXXXXXXXXXXXX0XXXXXX
X000000000000X0X000000X0F0000000000000000000000000F0X
X0XXXXXXXXXXXX0X000G00X00000000000000000000000000000X
X00000000000000X000000X0XXXXXXXXXXXXXXXXXXXXXXXXXXX0X
XXXXXXXXXXXXXXXX0XXXXXX0F0000000000000000000000000F0X
X00000X000000XIX0X0000X00000000000000000000000000000X
X00000X0XXXX0X0X0X0X00XXXXXXXXXXXXXX0XXXXXXXXXXXXXXXX
X000000000FX00000X0XF0XE0000000000000000000000000000X
X00XXXXXXXXXXXXXXX0XXXXXXX0XXXX0XXXXXXXXXXXXXXXXXXX0X
X0000000000000000000000000000X00000000000000000000XEX
XXXXXXXXXXXXXXXXXXXXXXXXXXXXXXXXXXXXXXXXXXXXXXXXXXXXX
X000000000000000000000000000000000000000000000000000X
X0XXXX000XXX000XXX00X000X000X000X00XXX00X000X0XXXX00X
X0X000X000X000X000X0X00X0000X000X0X000X0X000X0X000X0X
X0X000X000X000X00000X0X00000X000X0X000X0X000X0X000X0X
X0XXXX0000X000X00000XX0000000X0X00X000X0X000X0XXXX00X
X0X0000000X000X00000X0X0000000X000X000X0X000X0X0X000X
X0X0000000X000X000X0X00X000000X000X000X0X000X0X00X00X
X0X000000XXX000XXX00X000X00000X0000XXX000XXX00X000X0X
X000000000000000000000000000000000000000000000000000X
X0XXXX000XXX00XXXXX0X000X000X000X0XXXXX0X00000X00000X
X0X000X0X000X000X000X000X000X000X0X00X00X00000X00000X
X0X000X0X000X000X000X000X000X000X0X00000X00000X00000X
X0XXXX00XXXXX000X000XXXXX000X0X0X0XXXXX0X00000X00000X
X0X00000X000X000X000X000X000X0X0X0X00000X00000X00000X
X0X00000X000X000X000X000X000X0X0X0X00000X00000X00000X
X0X00000X000X000X000X000X0000X0X00XXXXX0XXXXX0XXXXX0X
X000000000000000000000000000000000000000000000000000X
XXXXXXXXXXXXXXXXXXXXXXXXXXXXXXXXXXXXXXXXXXXXXXXXXXXXX