21
21
XXXXXXXXXXXXXXXXXXXXX
X000000000XE00000000X
XG000EF0X0X0X000XXX0X
X0000000X0X0X00000XSX
XXXXXXXXX0X0X0XXX0XXX
X000F000X0X0X0000000X
X0000000X0X000000000X
X000000000X000X000X0X
X0XXXXXXXXXXX0X0XXX0X
X0000000X00000X000X0X
XXXXXXX0XXXXX000X0X0X
X0000000000EX0000000X
X000000000XXX0X00XXXX
X000000000XD00000000X
X000000000XEXXXXXXX0X
X000000000X0X0000000X
X0XXXXXXXXX000XXX00HX
X000X000000000000000X
X000X0X0XX000000XXX0X
X00000X00000000F0000X
XXXXXXXXXXXXXXXXXXXXX